//MAP CONVERTED BY dmm2tgm.py THIS HEADER COMMENT PREVENTS RECONVERSION, DO NOT REMOVE
"bo" = (
/obj/machinery/atmospherics/pipe/smart/manifold4w/scrubbers/hidden/layer2{
	dir = 8
	},
/obj/machinery/atmospherics/pipe/smart/manifold4w/supply/hidden/layer4,
/obj/structure/cable,
/turf/open/floor/iron/white,
/area/station/medical/chemistry)
"bt" = (
/obj/effect/turf_decal/trimline/blue/filled/line{
	dir = 9
	},
/obj/machinery/button/door{
	id = "durka_bot_left";
	name = "Бронежалюзи нижние левые";
	pixel_x = -28
	},
/turf/open/floor/iron/white,
/area/station/medical/chemistry)
"cd" = (
/obj/machinery/firealarm/directional/east,
/obj/machinery/camera/directional/east{
	c_tag = "Psychology";
	network = list("ss13","medbay");
	pixel_y = -22
	},
/obj/structure/chair/sofa/middle{
	dir = 8
	},
/turf/open/floor/carpet/blue,
/area/station/medical/psychology)
"dP" = (
/obj/machinery/light/small/directional/west,
/obj/structure/bodycontainer/morgue,
/obj/effect/turf_decal/trimline/neutral/warning,
/obj/effect/turf_decal/tile/neutral/half{
	dir = 8
	},
/turf/open/floor/iron/dark/smooth_half{
	dir = 4
	},
/area/station/medical/morgue)
"ee" = (
/obj/structure/filingcabinet,
/turf/open/floor/iron/white/smooth_large,
/area/station/medical/psychology)
"em" = (
/obj/effect/turf_decal/trimline/blue/filled/line,
/obj/item/radio/intercom{
	pixel_y = -35
	},
/obj/machinery/atmospherics/pipe/smart/manifold4w/supply/hidden/layer4,
/obj/machinery/atmospherics/pipe/smart/manifold4w/scrubbers/hidden/layer2{
	dir = 8
	},
/obj/structure/cable,
/turf/open/floor/iron/white,
/area/station/medical/medbay/extra)
"fa" = (
/obj/machinery/atmospherics/components/unary/vent_pump/on/layer4,
/turf/open/floor/iron/white/smooth_large,
/area/station/medical/psychology)
"fc" = (
/obj/structure/cable,
/obj/machinery/atmospherics/pipe/smart/manifold4w/scrubbers/hidden/layer2{
	dir = 8
	},
/obj/machinery/atmospherics/pipe/smart/manifold4w/supply/hidden/layer4,
/obj/machinery/button/door{
	id = "durka_bot_right";
	name = "Бронежалюзи нижние правые";
	pixel_y = -32
	},
/turf/open/floor/plating,
/area/station/medical/psychology)
"fY" = (
/obj/effect/turf_decal/tile/neutral/half{
	dir = 4
	},
/obj/effect/landmark/start/coroner,
/turf/open/floor/iron/dark/smooth_edge{
	dir = 4
	},
/area/station/medical/morgue)
"ge" = (
/obj/effect/turf_decal/trimline/blue/filled/line{
	dir = 8
	},
/turf/open/floor/iron/white,
/area/station/medical/chemistry)
"gC" = (
/obj/effect/turf_decal/trimline/neutral/warning{
	dir = 5
	},
/turf/open/floor/iron/dark/smooth_half{
	dir = 4
	},
/area/station/medical/morgue)
"gL" = (
/obj/machinery/atmospherics/pipe/smart/manifold4w/supply/hidden/layer4,
/turf/open/floor/carpet/blue,
/area/station/medical/psychology)
"hj" = (
/obj/effect/turf_decal/trimline/blue/filled/line{
	dir = 4
	},
/obj/structure/table,
/obj/item/stack/ducts/fifty,
/obj/item/stack/ducts/fifty,
/obj/item/stack/ducts/fifty,
/obj/item/stack/ducts/fifty,
/obj/item/stack/ducts/fifty,
/obj/item/plunger,
/turf/open/floor/iron/white,
/area/station/medical/chemistry)
"hG" = (
/obj/effect/turf_decal/trimline/blue/filled/line{
	dir = 4
	},
/obj/machinery/atmospherics/pipe/smart/manifold4w/supply/hidden/layer4,
/obj/machinery/atmospherics/pipe/smart/manifold4w/scrubbers/hidden/layer2{
	dir = 8
	},
/obj/structure/cable,
/turf/open/floor/iron/white/smooth_large,
/area/station/medical/medbay/extra)
"ir" = (
/turf/open/floor/iron/white/smooth_large,
/area/station/medical/chemistry)
"iT" = (
/obj/machinery/atmospherics/pipe/smart/manifold4w/supply/hidden/layer4,
/obj/structure/cable,
/obj/machinery/power/apc/auto_name/directional/south,
/turf/open/floor/iron/dark,
/area/station/medical/morgue)
"iW" = (
/obj/effect/turf_decal/trimline/blue/filled/line{
	dir = 5
	},
/obj/machinery/light/directional/east,
/obj/machinery/atmospherics/pipe/smart/manifold4w/scrubbers/hidden/layer2{
	dir = 8
	},
/obj/machinery/atmospherics/pipe/smart/manifold4w/supply/hidden/layer4,
/obj/structure/sign/departments/chemistry{
	pixel_y = 32
	},
/turf/open/floor/iron/white,
/area/station/medical/medbay/extra)
"jI" = (
/obj/effect/turf_decal/trimline/blue/filled/line{
	dir = 8
	},
/obj/machinery/firealarm{
	dir = 4;
	pixel_x = -24
	},
/obj/structure/stairs/north,
/turf/open/floor/iron/white,
/area/station/medical/medbay/extra)
"jN" = (
/obj/structure/bodycontainer/morgue,
/obj/effect/turf_decal/trimline/neutral/warning{
	dir = 1
	},
/obj/effect/turf_decal/tile/neutral/half{
	dir = 8
	},
/turf/open/floor/iron/dark/smooth_large,
/area/station/medical/morgue)
"lq" = (
/turf/open/floor/iron/dark,
/area/station/medical/morgue)
"lX" = (
/obj/machinery/atmospherics/pipe/smart/manifold4w/general/visible,
/obj/effect/turf_decal/trimline/blue/filled/line{
	dir = 8
	},
/obj/machinery/light/directional/west,
/obj/effect/mapping_helpers/requests_console/assistance,
/obj/structure/railing,
/obj/machinery/requests_console/auto_name/directional/west,
/turf/open/floor/iron/white,
/area/station/medical/medbay/extra)
"ny" = (
/obj/structure/bodycontainer/morgue,
/obj/structure/sign/clock/directional/west,
/obj/effect/turf_decal/tile/neutral/half{
	dir = 8
	},
/turf/open/floor/iron/dark/smooth_half{
	dir = 4
	},
/area/station/medical/morgue)
"nJ" = (
/obj/structure/table/reinforced,
/obj/machinery/computer/records/medical/laptop,
/obj/item/radio/intercom/directional/north,
/turf/open/floor/iron/dark,
/area/station/medical/morgue)
"ob" = (
/obj/machinery/atmospherics/pipe/smart/manifold4w/general/visible,
/obj/structure/railing,
/turf/open/floor/iron/white/smooth_large,
/area/station/medical/medbay/extra)
"oe" = (
/obj/machinery/cryo_cell,
/obj/effect/turf_decal/trimline/blue/filled/line{
	dir = 1
	},
/turf/open/floor/iron/white,
/area/station/medical/medbay/extra)
"os" = (
/obj/structure/table/optable,
/obj/effect/turf_decal/tile/neutral/fourcorners,
/turf/open/floor/iron/dark,
/area/station/medical/morgue)
"oH" = (
/obj/machinery/atmospherics/pipe/smart/manifold4w/general/visible,
/turf/open/floor/iron/white/smooth_large,
/area/station/medical/medbay/extra)
"oW" = (
/obj/machinery/atmospherics/components/unary/vent_scrubber/on/layer2{
	dir = 4
	},
/obj/structure/cable,
/obj/effect/turf_decal/trimline/blue/filled/line,
/turf/open/floor/iron/white/smooth_large,
/area/station/medical/chemistry)
"pt" = (
/obj/machinery/atmospherics/components/unary/vent_scrubber/on/layer2{
	dir = 4
	},
/turf/open/floor/iron/white/smooth_large,
/area/station/medical/medbay/extra)
"pR" = (
/obj/structure/table/wood,
/obj/machinery/computer/records/medical/laptop{
	dir = 4
	},
/turf/open/floor/iron/white/smooth_large,
/area/station/medical/psychology)
"pX" = (
/obj/machinery/atmospherics/components/unary/vent_pump/on/layer4{
	dir = 4
	},
/obj/machinery/airalarm/directional/south{
	pixel_y = -23
	},
/obj/effect/turf_decal/trimline/neutral/warning{
	dir = 6
	},
/turf/open/floor/iron/dark/smooth_half{
	dir = 4
	},
/area/station/medical/morgue)
"qp" = (
/obj/effect/turf_decal/trimline/blue/filled/line{
	dir = 1
	},
/obj/machinery/atmospherics/pipe/smart/manifold4w/scrubbers/hidden/layer2{
	dir = 8
	},
/obj/machinery/atmospherics/pipe/smart/manifold4w/supply/hidden/layer4,
/obj/structure/cable,
/turf/open/floor/iron/white,
/area/station/medical/medbay/extra)
"qT" = (
/obj/structure/closet/secure_closet/psychology,
/turf/open/floor/iron/white/smooth_large,
/area/station/medical/psychology)
"ru" = (
/obj/effect/turf_decal/trimline/blue/filled/line{
	dir = 1
	},
/obj/structure/table/glass,
/obj/machinery/airalarm/directional/north{
	pixel_y = 23
	},
/obj/item/storage/box/beakers{
	pixel_x = -8;
	pixel_y = 12
	},
/obj/item/reagent_containers/dropper,
/turf/open/floor/iron/white,
/area/station/medical/chemistry)
"sl" = (
/obj/machinery/firealarm{
	dir = 1;
	pixel_y = -24
	},
/obj/machinery/atmospherics/pipe/smart/manifold4w/scrubbers/hidden/layer2{
	dir = 8
	},
/obj/machinery/atmospherics/pipe/smart/manifold4w/supply/hidden/layer4,
/obj/structure/cable,
/obj/effect/turf_decal/trimline/blue/filled/line{
	dir = 10
	},
/turf/open/floor/iron/white,
/area/station/medical/chemistry)
"su" = (
/obj/machinery/atmospherics/pipe/smart/manifold4w/general/visible,
/obj/structure/railing/corner{
	dir = 8
	},
/turf/open/floor/iron/white/smooth_large,
/area/station/medical/medbay/extra)
"sL" = (
/obj/effect/mapping_helpers/dead_body_placer,
/obj/effect/turf_decal/trimline/neutral/warning{
	dir = 4
	},
/turf/open/floor/iron/dark/smooth_half{
	dir = 4
	},
/area/station/medical/morgue)
"tG" = (
/turf/closed/wall/r_wall,
/area/station/medical/psychology)
"tI" = (
/turf/template_noop,
/area/template_noop)
"ud" = (
/obj/effect/turf_decal/tile/neutral{
	dir = 4
	},
/obj/machinery/atmospherics/components/unary/vent_scrubber/on/layer2,
/turf/open/floor/iron/dark,
/area/station/medical/morgue)
"uk" = (
/obj/machinery/atmospherics/pipe/smart/manifold4w/scrubbers/hidden/layer2{
	dir = 8
	},
/turf/open/floor/iron/white/smooth_large,
/area/station/medical/medbay/extra)
"uL" = (
/obj/effect/turf_decal/trimline/neutral/warning{
	dir = 4
	},
/turf/open/floor/iron/dark/smooth_half{
	dir = 4
	},
/area/station/medical/morgue)
"uR" = (
/obj/effect/turf_decal/trimline/blue/filled/line,
/obj/machinery/atmospherics/pipe/smart/manifold4w/supply/hidden/layer4,
/obj/machinery/airalarm/directional/south{
	pixel_y = -23
	},
/obj/machinery/light/directional/south,
/obj/machinery/atmospherics/pipe/smart/manifold4w/scrubbers/hidden/layer2{
	dir = 8
	},
/obj/structure/cable,
/turf/open/floor/iron/white,
/area/station/medical/medbay/extra)
"vQ" = (
/obj/effect/turf_decal/trimline/blue/filled/line{
	dir = 5
	},
/obj/structure/table,
/obj/item/storage/toolbox/mechanical{
	pixel_y = 11
	},
/obj/item/clothing/head/utility/welding,
/obj/item/construction/plumbing{
	pixel_y = -10
	},
/turf/open/floor/iron/white,
/area/station/medical/chemistry)
"vY" = (
/obj/effect/turf_decal/trimline/blue/filled/line{
	dir = 5
	},
/obj/machinery/light/small/directional/north,
/obj/machinery/airalarm/directional/east{
	pixel_x = 23
	},
/turf/open/floor/iron/white,
/area/station/medical/chemistry)
"xl" = (
/obj/structure/cable,
/turf/open/floor/iron/white/smooth_large,
/area/station/medical/chemistry)
"xH" = (
/obj/effect/turf_decal/trimline/blue/filled/line,
/obj/machinery/atmospherics/pipe/smart/manifold4w/scrubbers/hidden/layer2{
	dir = 8
	},
/obj/machinery/atmospherics/pipe/smart/manifold4w/supply/hidden/layer4,
/obj/structure/cable,
/turf/open/floor/iron/white,
/area/station/medical/medbay/extra)
"xJ" = (
/obj/effect/turf_decal/trimline/blue/filled/line{
	dir = 1
	},
/obj/structure/cable,
/obj/machinery/power/apc/auto_name/directional/north,
/turf/open/floor/iron/white,
/area/station/medical/chemistry)
"xQ" = (
/obj/machinery/door/airlock/medical{
	name = "Morgue"
	},
/obj/effect/mapping_helpers/airlock/access/all/medical/morgue,
/obj/machinery/atmospherics/pipe/smart/manifold4w/supply/hidden/layer4,
/obj/machinery/atmospherics/pipe/smart/manifold4w/scrubbers/hidden/layer2{
	dir = 8
	},
/obj/structure/cable,
/turf/open/floor/iron/dark,
/area/station/medical/medbay/extra)
"ys" = (
/obj/machinery/holopad,
/turf/open/floor/iron/white/smooth_large,
/area/station/medical/medbay/extra)
"yu" = (
/obj/effect/turf_decal/trimline/blue/filled/line{
	dir = 1
	},
/obj/machinery/chem_dispenser,
/obj/structure/extinguisher_cabinet{
	pixel_x = 5;
	pixel_y = 30
	},
/turf/open/floor/iron/white,
/area/station/medical/chemistry)
"yL" = (
/obj/machinery/atmospherics/pipe/smart/manifold4w/scrubbers/hidden/layer2{
	dir = 8
	},
/obj/machinery/atmospherics/pipe/smart/manifold4w/supply/hidden/layer4,
/obj/structure/cable,
/obj/effect/turf_decal/trimline/blue/filled/line{
	dir = 6
	},
/obj/structure/table/glass,
/obj/item/wrench/medical{
	pixel_x = -6;
	pixel_y = 13
	},
/obj/item/reagent_containers/cup/beaker/cryoxadone{
	pixel_x = 7;
	pixel_y = 9
	},
/obj/item/reagent_containers/cup/beaker/cryoxadone{
	pixel_y = 5
	},
/obj/item/reagent_containers/cup/beaker/cryoxadone{
	pixel_x = 7;
	pixel_y = 1
	},
/obj/item/reagent_containers/cup/beaker/cryoxadone{
	pixel_x = -7;
	pixel_y = 1
	},
/obj/item/storage/pill_bottle/mannitol{
	pixel_y = -3
	},
/turf/open/floor/iron/white,
/area/station/medical/medbay/extra)
"zk" = (
/obj/machinery/camera/autoname/directional/east,
/obj/effect/turf_decal/tile/neutral/half{
	dir = 1
	},
/obj/structure/table,
/obj/item/storage/box/bodybags,
/obj/item/pen,
/turf/open/floor/iron/dark,
/area/station/medical/morgue)
"zr" = (
/obj/machinery/atmospherics/pipe/smart/manifold4w/supply/hidden/layer4,
/obj/machinery/atmospherics/pipe/smart/manifold4w/scrubbers/hidden/layer2{
	dir = 8
	},
/obj/structure/cable,
/obj/effect/turf_decal/trimline/blue/filled/corner{
	dir = 8
	},
/turf/open/floor/iron/white/smooth_large,
/area/station/medical/chemistry)
"zM" = (
/obj/machinery/atmospherics/components/unary/vent_pump/on/layer4,
/obj/structure/railing{
	dir = 8
	},
/turf/open/floor/iron/white/smooth_large,
/area/station/medical/medbay/extra)
"zW" = (
/obj/machinery/atmospherics/components/unary/vent_pump/on/layer4,
/turf/open/floor/iron/white/smooth_large,
/area/station/medical/chemistry)
"AP" = (
/obj/machinery/atmospherics/components/unary/portables_connector/visible,
/obj/machinery/portable_atmospherics/canister/oxygen,
/obj/item/wrench/medical,
/obj/effect/turf_decal/trimline/blue/filled/line{
	dir = 1
	},
/obj/machinery/camera/directional/north,
/turf/open/floor/iron/white,
/area/station/medical/medbay/extra)
"AQ" = (
/obj/effect/turf_decal/trimline/blue/filled/line{
	dir = 1
	},
/obj/machinery/chem_heater,
/obj/machinery/camera/directional/north{
	c_tag = "Chemistry Lab North";
	network = list("ss13","medbay")
	},
/turf/open/floor/iron/white,
/area/station/medical/chemistry)
"Cb" = (
/turf/closed/wall/r_wall,
/area/station/medical/chemistry)
"CE" = (
/obj/machinery/door/airlock/maintenance{
	dir = 4;
	name = "Medbay Maintenance"
	},
/obj/machinery/door/poddoor/shutters{
	id = "durka_bot_left";
	name = "Бронежалюзи нижние левые"
	},
/turf/open/floor/plating,
/area/station/medical/chemistry)
"CT" = (
/obj/effect/turf_decal/trimline/blue/filled/line,
/obj/machinery/atmospherics/pipe/smart/manifold4w/scrubbers/hidden/layer2{
	dir = 8
	},
/obj/machinery/atmospherics/pipe/smart/manifold4w/supply/hidden/layer4,
/obj/structure/cable,
/turf/open/floor/iron/white,
/area/station/medical/chemistry)
"Df" = (
/obj/structure/stairs/north,
/turf/open/floor/iron/white/smooth_large,
/area/station/medical/medbay/extra)
"Ev" = (
/obj/machinery/vending/wardrobe/chem_wardrobe,
/obj/effect/turf_decal/trimline/blue/filled/line{
	dir = 10
	},
/turf/open/floor/iron/white,
/area/station/medical/chemistry)
"EH" = (
/obj/machinery/light/directional/south,
/obj/machinery/power/apc/auto_name/directional/south,
/obj/structure/cable,
/obj/machinery/atmospherics/pipe/smart/manifold4w/scrubbers/hidden/layer2{
	dir = 8
	},
/turf/open/floor/carpet/blue,
/area/station/medical/psychology)
"EO" = (
/obj/effect/turf_decal/trimline/blue/filled/line,
/obj/machinery/atmospherics/pipe/smart/manifold4w/supply/hidden/layer4,
/obj/structure/railing/corner{
	dir = 1
	},
/obj/machinery/atmospherics/pipe/smart/manifold4w/scrubbers/hidden/layer2{
	dir = 8
	},
/obj/structure/cable,
/turf/open/floor/iron/white,
/area/station/medical/medbay/extra)
"Fb" = (
/turf/closed/wall/r_wall,
/area/station/medical/medbay/extra)
"Fm" = (
/obj/effect/turf_decal/trimline/blue/filled/line{
	dir = 6
	},
/obj/machinery/atmospherics/pipe/smart/manifold4w/supply/hidden/layer4,
/obj/machinery/atmospherics/pipe/smart/manifold4w/scrubbers/hidden/layer2{
	dir = 8
	},
/obj/structure/cable,
/turf/open/floor/iron/white,
/area/station/medical/chemistry)
"FW" = (
/obj/machinery/airalarm/directional/east{
	pixel_x = 23
	},
/obj/structure/chair/sofa/left{
	dir = 8
	},
/turf/open/floor/carpet/blue,
/area/station/medical/psychology)
"Gx" = (
/obj/machinery/vending/wardrobe/coroner_wardrobe,
/turf/open/floor/iron/dark,
/area/station/medical/morgue)
"Hp" = (
/obj/effect/turf_decal/trimline/blue/filled/line,
/obj/machinery/atmospherics/pipe/smart/manifold4w/scrubbers/hidden/layer2{
	dir = 8
	},
/obj/machinery/atmospherics/pipe/smart/manifold4w/supply/hidden/layer4,
/obj/machinery/power/apc/auto_name/directional/south,
/obj/structure/cable,
/turf/open/floor/iron/white,
/area/station/medical/medbay/extra)
"HV" = (
/obj/machinery/atmospherics/pipe/smart/manifold4w/supply/hidden/layer4,
/obj/machinery/atmospherics/pipe/smart/manifold4w/scrubbers/hidden/layer2{
	dir = 8
	},
/obj/structure/cable,
/obj/effect/turf_decal/trimline/blue/filled/line,
/turf/open/floor/iron/white/smooth_large,
/area/station/medical/chemistry)
"JJ" = (
/obj/effect/turf_decal/trimline/blue/filled/line{
	dir = 1
	},
/obj/machinery/atmospherics/components/unary/vent_pump/on/layer4,
/turf/open/floor/iron/white,
/area/station/medical/chemistry)
"JK" = (
/obj/structure/table/wood,
/obj/item/paper_bin/carbon,
/obj/item/pen,
/obj/item/radio/intercom{
	pixel_y = -35
	},
/turf/open/floor/iron/white/smooth_large,
/area/station/medical/psychology)
"JR" = (
/obj/machinery/atmospherics/pipe/smart/manifold4w/supply/hidden/layer4,
/obj/machinery/atmospherics/pipe/smart/manifold4w/scrubbers/hidden/layer2{
	dir = 8
	},
/obj/structure/cable,
/obj/machinery/light_switch{
	pixel_y = -25
	},
/turf/open/floor/iron/dark,
/area/station/medical/morgue)
"Kn" = (
/obj/machinery/atmospherics/pipe/smart/manifold4w/scrubbers/hidden/layer2{
	dir = 8
	},
/turf/open/floor/iron/dark,
/area/station/medical/morgue)
"LR" = (
/turf/closed/wall/r_wall,
/area/station/medical/morgue)
"No" = (
/obj/machinery/atmospherics/components/unary/portables_connector/visible,
/obj/machinery/portable_atmospherics/canister/oxygen,
/obj/effect/turf_decal/trimline/blue/filled/line{
	dir = 9
	},
/obj/structure/sign/warning/no_smoking/circle{
	pixel_x = -32
	},
/turf/open/floor/iron/white,
/area/station/medical/medbay/extra)
"Nx" = (
/obj/structure/chair/sofa/right{
	dir = 8
	},
/obj/item/toy/plush/moth,
/turf/open/floor/carpet/blue,
/area/station/medical/psychology)
"Ob" = (
/obj/effect/turf_decal/trimline/blue/filled/line{
	dir = 1
	},
/obj/machinery/chem_mass_spec,
/turf/open/floor/iron/white,
/area/station/medical/chemistry)
"Oe" = (
/obj/machinery/atmospherics/components/unary/vent_scrubber/on/layer2,
/turf/open/floor/iron/white/smooth_large,
/area/station/medical/chemistry)
"Pe" = (
/obj/machinery/holopad,
/turf/open/floor/iron/white/smooth_large,
/area/station/medical/chemistry)
"Pk" = (
/obj/structure/extinguisher_cabinet{
	pixel_x = -5;
	pixel_y = 30
	},
/obj/structure/chair/office/light{
	dir = 8
	},
/obj/effect/landmark/start/psychologist,
/turf/open/floor/iron/white/smooth_large,
/area/station/medical/psychology)
"PF" = (
/obj/machinery/holopad,
/turf/open/floor/iron/dark,
/area/station/medical/morgue)
"Qg" = (
/obj/machinery/atmospherics/pipe/smart/manifold4w/supply/hidden/layer4,
/obj/machinery/atmospherics/pipe/smart/manifold4w/scrubbers/hidden/layer2{
	dir = 8
	},
/obj/structure/cable,
/obj/structure/bookcase/random/reference,
/turf/open/floor/plating,
/area/station/medical/psychology)
"Qn" = (
/obj/structure/chair/office/light{
	dir = 1
	},
/obj/effect/landmark/start/chemist,
/turf/open/floor/iron/white/smooth_large,
/area/station/medical/chemistry)
"RC" = (
/obj/machinery/atmospherics/components/unary/thermomachine/freezer,
/obj/effect/turf_decal/trimline/blue/filled/line{
	dir = 1
	},
/obj/structure/sign/warning/cold_temp{
	pixel_y = 32
	},
/turf/open/floor/iron/white,
/area/station/medical/medbay/extra)
"RE" = (
/obj/machinery/computer/operating{
	dir = 8
	},
/obj/machinery/light/small/directional/east,
/obj/effect/turf_decal/tile/neutral/fourcorners,
/turf/open/floor/iron/dark,
/area/station/medical/morgue)
"RS" = (
/obj/machinery/door/airlock/medical/glass{
	name = "Chemistry Storage"
	},
/obj/machinery/atmospherics/pipe/smart/manifold4w/scrubbers/hidden/layer2{
	dir = 8
	},
/obj/machinery/atmospherics/pipe/smart/manifold4w/supply/hidden/layer4,
/obj/structure/cable,
/obj/effect/mapping_helpers/airlock/access/all/medical/pharmacy,
/obj/machinery/door/firedoor,
/turf/open/floor/iron/white,
/area/station/medical/chemistry)
"RU" = (
/obj/machinery/atmospherics/components/unary/vent_scrubber/on/layer2,
/turf/open/floor/carpet/blue,
/area/station/medical/psychology)
"Sl" = (
/obj/machinery/light/directional/north,
/turf/open/floor/iron/white/smooth_large,
/area/station/medical/psychology)
"SA" = (
/obj/effect/turf_decal/trimline/blue/filled/corner{
	dir = 4
	},
/turf/open/floor/iron/white,
/area/station/medical/chemistry)
"SX" = (
/obj/effect/turf_decal/trimline/blue/filled/line{
	dir = 1
	},
/obj/structure/table,
/obj/machinery/reagentgrinder,
/obj/item/stack/sheet/mineral/plasma,
/turf/open/floor/iron/white,
/area/station/medical/chemistry)
"Te" = (
/obj/effect/turf_decal/trimline/blue/filled/line{
	dir = 1
	},
/obj/machinery/light/directional/north,
/obj/machinery/chem_master,
/turf/open/floor/iron/white,
/area/station/medical/chemistry)
"To" = (
/turf/open/floor/iron/white/smooth_large,
/area/station/medical/psychology)
"Ud" = (
/obj/machinery/atmospherics/pipe/smart/manifold4w/supply/hidden/layer4,
/obj/machinery/atmospherics/pipe/smart/manifold4w/scrubbers/hidden/layer2{
	dir = 8
	},
/obj/structure/cable,
/obj/structure/sign/departments/psychology{
	pixel_y = -32
	},
/obj/machinery/door/airlock/medical{
	name = "Psychology"
	},
/obj/effect/mapping_helpers/airlock/access/all/medical/psychology,
/obj/machinery/door/firedoor,
/turf/open/floor/iron/white/smooth_large,
/area/station/medical/psychology)
"Up" = (
/obj/structure/table/reinforced,
/obj/item/surgery_tray/full/morgue,
/obj/effect/turf_decal/tile/neutral/half{
	dir = 4
	},
/obj/machinery/newscaster/directional/north,
/turf/open/floor/iron/dark/smooth_edge{
	dir = 4
	},
/area/station/medical/morgue)
"VX" = (
/obj/machinery/atmospherics/pipe/smart/manifold4w/supply/hidden/layer4,
/obj/machinery/atmospherics/pipe/smart/manifold4w/scrubbers/hidden/layer2{
	dir = 8
	},
/obj/structure/cable,
/turf/open/floor/carpet/blue,
/area/station/medical/psychology)
"WM" = (
/obj/machinery/door/airlock/maintenance{
	dir = 4;
	name = "Medbay Maintenance"
	},
/obj/structure/cable,
/obj/machinery/atmospherics/pipe/smart/manifold4w/scrubbers/hidden/layer2{
	dir = 8
	},
/obj/machinery/atmospherics/pipe/smart/manifold4w/supply/hidden/layer4,
/obj/machinery/door/poddoor/shutters{
	id = "durka_bot_right";
	name = "Бронежалюзи нижние правые"
	},
/obj/machinery/door/firedoor,
/turf/open/floor/plating,
/area/station/medical/psychology)
"WQ" = (
/obj/structure/bodycontainer/morgue,
/obj/effect/turf_decal/tile/neutral/half{
	dir = 8
	},
/turf/open/floor/iron/dark/smooth_half{
	dir = 4
	},
/area/station/medical/morgue)
"WW" = (
/obj/structure/cable,
/obj/effect/turf_decal/trimline/blue/filled/line,
/turf/open/floor/iron/white/smooth_large,
/area/station/medical/chemistry)
"Xd" = (
/obj/machinery/holopad,
/turf/open/floor/carpet/blue,
/area/station/medical/psychology)
"YD" = (
/obj/effect/turf_decal/trimline/blue/filled/line{
	dir = 10
	},
/obj/machinery/atmospherics/pipe/smart/manifold4w/supply/hidden/layer4,
/obj/machinery/atmospherics/pipe/smart/manifold4w/scrubbers/hidden/layer2{
	dir = 8
	},
/obj/structure/cable,
/turf/open/floor/iron/white,
/area/station/medical/medbay/extra)
"Zd" = (
/obj/structure/cable,
/turf/open/floor/iron/white/smooth_large,
/area/station/medical/medbay/extra)
"Zp" = (
/obj/effect/turf_decal/trimline/blue/filled/line{
	dir = 1
	},
/turf/open/floor/iron/white,
/area/station/medical/chemistry)
"ZB" = (
/obj/machinery/atmospherics/pipe/smart/manifold4w/supply/hidden/layer4,
/obj/machinery/atmospherics/pipe/smart/manifold4w/scrubbers/hidden/layer2{
	dir = 8
	},
/obj/structure/cable,
/turf/open/floor/iron/dark,
/area/station/medical/morgue)

(1,1,1) = {"
tI
tI
tI
tI
tI
tI
tI
tI
tI
tI
tI
tI
tI
tI
tI
tI
tI
tI
tI
tI
tI
tI
tI
tI
tI
tI
tI
tI
tI
tI
tI
tI
tI
tI
tI
tI
tI
tI
tI
tI
"}
(2,1,1) = {"
tI
tI
tI
tI
tI
tI
tI
tI
tI
tI
tI
tI
tI
tI
tI
tI
tI
tI
tI
tI
tI
tI
tI
tI
tI
tI
tI
tI
tI
tI
tI
tI
tI
tI
tI
tI
tI
tI
tI
tI
"}
(3,1,1) = {"
tI
tI
tI
tI
tI
tI
tI
tI
tI
tI
tI
tI
tI
tI
tI
tI
tI
tI
tI
tI
tI
tI
tI
tI
tI
tI
tI
tI
tI
tI
tI
tI
tI
tI
tI
tI
tI
tI
tI
tI
"}
(4,1,1) = {"
tI
tI
tI
tI
tI
tI
tI
tI
tI
Cb
Cb
Cb
Cb
LR
LR
LR
LR
LR
LR
LR
tI
tI
tI
tI
tI
tI
tI
tI
tI
tI
tI
tI
tI
tI
tI
tI
tI
tI
tI
tI
"}
(5,1,1) = {"
tI
tI
tI
tI
tI
tI
tI
tI
tI
CE
bt
ge
Ev
LR
jN
ny
WQ
WQ
dP
LR
tI
tI
tI
tI
tI
tI
tI
tI
tI
tI
tI
tI
tI
tI
tI
tI
tI
tI
tI
tI
"}
(6,1,1) = {"
tI
tI
tI
tI
tI
tI
tI
tI
tI
Cb
xJ
xl
WW
LR
gC
uL
sL
uL
pX
LR
tI
tI
tI
tI
tI
tI
tI
tI
tI
tI
tI
tI
tI
tI
tI
tI
tI
tI
tI
tI
"}
(7,1,1) = {"
tI
tI
tI
tI
tI
tI
tI
tI
tI
Cb
Ob
Pe
oW
LR
nJ
lq
PF
lq
iT
LR
tI
tI
tI
tI
tI
tI
tI
tI
tI
tI
tI
tI
tI
tI
tI
tI
tI
tI
tI
tI
"}
(8,1,1) = {"
tI
tI
tI
tI
tI
tI
tI
tI
tI
Cb
ru
zW
HV
LR
Up
fY
ud
Kn
ZB
LR
tI
tI
tI
tI
tI
tI
tI
tI
tI
tI
tI
tI
tI
tI
tI
tI
tI
tI
tI
tI
"}
(9,1,1) = {"
tI
tI
tI
tI
tI
tI
tI
tI
tI
Cb
AQ
ir
HV
LR
RE
os
zk
Gx
JR
LR
tI
tI
tI
tI
tI
tI
tI
tI
tI
tI
tI
tI
tI
tI
tI
tI
tI
tI
tI
tI
"}
(10,1,1) = {"
tI
tI
tI
tI
tI
tI
tI
tI
tI
Cb
yu
Qn
HV
LR
LR
Fb
Fb
Fb
xQ
Fb
tI
tI
tI
tI
tI
tI
tI
tI
tI
tI
tI
tI
tI
tI
tI
tI
tI
tI
tI
tI
"}
(11,1,1) = {"
tI
tI
tI
tI
tI
tI
tI
tI
tI
Cb
Te
ir
zr
sl
Cb
No
lX
jI
YD
Fb
tI
tI
tI
tI
tI
tI
tI
tI
tI
tI
tI
tI
tI
tI
tI
tI
tI
tI
tI
tI
"}
(12,1,1) = {"
tI
tI
tI
tI
tI
tI
tI
tI
tI
Cb
SX
Oe
ir
bo
Cb
AP
ob
Df
em
Fb
tI
tI
tI
tI
tI
tI
tI
tI
tI
tI
tI
tI
tI
tI
tI
tI
tI
tI
tI
tI
"}
(13,1,1) = {"
tI
tI
tI
tI
tI
tI
tI
tI
tI
Cb
vQ
hj
SA
CT
Cb
oe
su
zM
EO
Fb
tI
tI
tI
tI
tI
tI
tI
tI
tI
tI
tI
tI
tI
tI
tI
tI
tI
tI
tI
tI
"}
(14,1,1) = {"
tI
tI
tI
tI
tI
tI
tI
tI
tI
Cb
Cb
Cb
Zp
CT
Cb
RC
oH
pt
uR
Fb
tI
tI
tI
tI
tI
tI
tI
tI
tI
tI
tI
tI
tI
tI
tI
tI
tI
tI
tI
tI
"}
(15,1,1) = {"
tI
tI
tI
tI
tI
tI
tI
tI
tI
tI
tI
Cb
JJ
CT
Cb
oe
oH
uk
Hp
Fb
tI
tI
tI
tI
tI
tI
tI
tI
tI
tI
tI
tI
tI
tI
tI
tI
tI
tI
tI
tI
"}
(16,1,1) = {"
tI
tI
tI
tI
tI
tI
tI
tI
tI
tI
tI
Cb
vY
Fm
RS
qp
Zd
ys
xH
Fb
tI
tI
tI
tI
tI
tI
tI
tI
tI
tI
tI
tI
tI
tI
tI
tI
tI
tI
tI
tI
"}
(17,1,1) = {"
tI
tI
tI
tI
tI
tI
tI
tI
tI
tI
tI
tG
tG
tG
tG
iW
hG
hG
yL
Fb
tI
tI
tI
tI
tI
tI
tI
tI
tI
tI
tI
tI
tI
tI
tI
tI
tI
tI
tI
tI
"}
(18,1,1) = {"
tI
tI
tI
tI
tI
tI
tI
tI
tI
tI
tI
tG
pR
JK
tG
tG
Ud
tG
tG
tG
tI
tI
tI
tI
tI
tI
tI
tI
tI
tI
tI
tI
tI
tI
tI
tI
tI
tI
tI
tI
"}
(19,1,1) = {"
tI
tI
tI
tI
tI
tI
tI
tI
tI
tI
tI
tG
Pk
fa
gL
gL
VX
Qg
fc
tG
tI
tI
tI
tI
tI
tI
tI
tI
tI
tI
tI
tI
tI
tI
tI
tI
tI
tI
tI
tI
"}
(20,1,1) = {"
tI
tI
tI
tI
tI
tI
tI
tI
tI
tI
tI
tG
Sl
To
Xd
RU
EH
tG
WM
tG
tI
tI
tI
tI
tI
tI
tI
tI
tI
tI
tI
tI
tI
tI
tI
tI
tI
tI
tI
tI
"}
(21,1,1) = {"
tI
tI
tI
tI
tI
tI
tI
tI
tI
tI
tI
tG
ee
qT
Nx
cd
FW
tG
tI
tI
tI
tI
tI
tI
tI
tI
tI
tI
tI
tI
tI
tI
tI
tI
tI
tI
tI
tI
tI
tI
"}
(22,1,1) = {"
tI
tI
tI
tI
tI
tI
tI
tI
tI
tI
tI
tG
tG
tG
tG
tG
tG
tG
tI
tI
tI
tI
tI
tI
tI
tI
tI
tI
tI
tI
tI
tI
tI
tI
tI
tI
tI
tI
tI
tI
"}
(23,1,1) = {"
tI
tI
tI
tI
tI
tI
tI
tI
tI
tI
tI
tI
tI
tI
tI
tI
tI
tI
tI
tI
tI
tI
tI
tI
tI
tI
tI
tI
tI
tI
tI
tI
tI
tI
tI
tI
tI
tI
tI
tI
"}
(24,1,1) = {"
tI
tI
tI
tI
tI
tI
tI
tI
tI
tI
tI
tI
tI
tI
tI
tI
tI
tI
tI
tI
tI
tI
tI
tI
tI
tI
tI
tI
tI
tI
tI
tI
tI
tI
tI
tI
tI
tI
tI
tI
"}
(25,1,1) = {"
tI
tI
tI
tI
tI
tI
tI
tI
tI
tI
tI
tI
tI
tI
tI
tI
tI
tI
tI
tI
tI
tI
tI
tI
tI
tI
tI
tI
tI
tI
tI
tI
tI
tI
tI
tI
tI
tI
tI
tI
"}
(26,1,1) = {"
tI
tI
tI
tI
tI
tI
tI
tI
tI
tI
tI
tI
tI
tI
tI
tI
tI
tI
tI
tI
tI
tI
tI
tI
tI
tI
tI
tI
tI
tI
tI
tI
tI
tI
tI
tI
tI
tI
tI
tI
"}
(27,1,1) = {"
tI
tI
tI
tI
tI
tI
tI
tI
tI
tI
tI
tI
tI
tI
tI
tI
tI
tI
tI
tI
tI
tI
tI
tI
tI
tI
tI
tI
tI
tI
tI
tI
tI
tI
tI
tI
tI
tI
tI
tI
"}
(28,1,1) = {"
tI
tI
tI
tI
tI
tI
tI
tI
tI
tI
tI
tI
tI
tI
tI
tI
tI
tI
tI
tI
tI
tI
tI
tI
tI
tI
tI
tI
tI
tI
tI
tI
tI
tI
tI
tI
tI
tI
tI
tI
"}
(29,1,1) = {"
tI
tI
tI
tI
tI
tI
tI
tI
tI
tI
tI
tI
tI
tI
tI
tI
tI
tI
tI
tI
tI
tI
tI
tI
tI
tI
tI
tI
tI
tI
tI
tI
tI
tI
tI
tI
tI
tI
tI
tI
"}
(30,1,1) = {"
tI
tI
tI
tI
tI
tI
tI
tI
tI
tI
tI
tI
tI
tI
tI
tI
tI
tI
tI
tI
tI
tI
tI
tI
tI
tI
tI
tI
tI
tI
tI
tI
tI
tI
tI
tI
tI
tI
tI
tI
"}
(31,1,1) = {"
tI
tI
tI
tI
tI
tI
tI
tI
tI
tI
tI
tI
tI
tI
tI
tI
tI
tI
tI
tI
tI
tI
tI
tI
tI
tI
tI
tI
tI
tI
tI
tI
tI
tI
tI
tI
tI
tI
tI
tI
"}
(32,1,1) = {"
tI
tI
tI
tI
tI
tI
tI
tI
tI
tI
tI
tI
tI
tI
tI
tI
tI
tI
tI
tI
tI
tI
tI
tI
tI
tI
tI
tI
tI
tI
tI
tI
tI
tI
tI
tI
tI
tI
tI
tI
"}
