//MAP CONVERTED BY dmm2tgm.py THIS HEADER COMMENT PREVENTS RECONVERSION, DO NOT REMOVE
"a" = (
/obj/structure/bed,
/obj/item/bedsheet/random,
/obj/effect/decal/cleanable/vomit/old,
/turf/open/floor/plating,
/area/template_noop)
"b" = (
/obj/effect/decal/cleanable/vomit/old,
/turf/open/floor/plating,
/area/template_noop)
"c" = (
/turf/closed/wall,
/area/template_noop)
"d" = (
/obj/structure/chair,
/turf/open/floor/plating,
/area/template_noop)
"e" = (
/turf/open/floor/plating,
/area/template_noop)
"f" = (
/obj/structure/table,
/obj/item/reagent_containers/cup/bottle/fluorine{
	pixel_x = 6
	},
/obj/item/reagent_containers/cup/bottle/hydrogen{
	pixel_x = -6
	},
/obj/item/reagent_containers/cup/bottle/water{
	pixel_y = 8
	},
/obj/effect/decal/cleanable/dirt,
/obj/effect/turf_decal/tile/yellow,
/obj/effect/turf_decal/tile/yellow{
	dir = 4
	},
/obj/structure/window/reinforced{
	dir = 8
	},
/turf/open/floor/iron,
/area/template_noop)
"g" = (
/obj/structure/table,
/obj/item/reagent_containers/cup/bottle/aluminium{
	pixel_x = 6
	},
/obj/item/reagent_containers/cup/bottle/bromine{
	pixel_x = -6
	},
/obj/effect/decal/cleanable/dirt,
/obj/effect/turf_decal/tile/yellow{
	dir = 1
	},
/obj/effect/turf_decal/tile/yellow{
	dir = 4
	},
/obj/effect/turf_decal/tile/yellow{
	dir = 8
	},
/obj/item/reagent_containers/cup/beaker/large,
/turf/open/floor/iron,
/area/template_noop)
"h" = (
/obj/structure/table,
/obj/item/reagent_containers/cup/bottle/carbon{
	pixel_x = 6
	},
/obj/item/reagent_containers/cup/bottle/chlorine{
	pixel_x = -6
	},
/obj/effect/decal/cleanable/dirt,
/obj/effect/turf_decal/tile/yellow{
	dir = 1
	},
/obj/effect/turf_decal/tile/yellow{
	dir = 4
	},
/obj/structure/table,
/obj/machinery/reagentgrinder,
/turf/open/floor/iron,
/area/template_noop)
"i" = (
/obj/structure/table,
/obj/item/reagent_containers/cup/bottle/copper{
	pixel_x = 6
	},
/obj/item/reagent_containers/cup/bottle/ethanol{
	pixel_x = -6
	},
/obj/effect/decal/cleanable/dirt,
/obj/effect/turf_decal/tile/yellow{
	dir = 1
	},
/obj/effect/turf_decal/tile/yellow,
/obj/effect/turf_decal/tile/yellow{
	dir = 4
	},
/turf/open/floor/iron,
/area/template_noop)
"j" = (
/obj/machinery/door/airlock,
/turf/open/floor/plating,
/area/template_noop)
"k" = (
/obj/effect/mapping_helpers/burnt_floor,
/turf/open/floor/plating,
/area/template_noop)
"l" = (
/obj/machinery/chem_master,
/obj/structure/window/reinforced{
	dir = 8
	},
/turf/open/floor/plating,
/area/template_noop)
"m" = (
/turf/open/floor/iron,
/area/template_noop)
"n" = (
/obj/structure/table,
/obj/item/reagent_containers/cup/bottle/mercury{
	pixel_x = 6;
	pixel_y = 8
	},
/obj/item/reagent_containers/cup/bottle/nitrogen{
	pixel_x = -6;
	pixel_y = 8
	},
/obj/item/reagent_containers/cup/bottle/oxygen{
	pixel_x = 6
	},
/obj/item/reagent_containers/cup/bottle/phosphorus{
	pixel_x = -6
	},
/obj/effect/decal/cleanable/dirt,
/obj/effect/decal/cleanable/dirt,
/turf/open/floor/iron,
/area/template_noop)
"o" = (
/obj/machinery/door/window/left/directional/west,
/obj/effect/mapping_helpers/burnt_floor,
/turf/open/floor/plating,
/area/template_noop)
"p" = (
/obj/effect/decal/cleanable/greenglow,
/turf/open/floor/iron,
/area/template_noop)
"q" = (
/obj/effect/decal/cleanable/insectguts,
/turf/open/floor/plating,
/area/template_noop)
"r" = (
/obj/structure/window/reinforced{
	dir = 8
	},
/obj/structure/table,
/obj/item/storage/box/beakers,
/turf/open/floor/iron,
/area/template_noop)
"s" = (
/obj/structure/table,
/obj/item/reagent_containers/cup/bottle/iodine{
	pixel_y = 8
	},
/obj/item/reagent_containers/cup/bottle/iron{
	pixel_x = 6
	},
/obj/item/reagent_containers/cup/bottle/lithium{
	pixel_x = -6
	},
/obj/effect/decal/cleanable/dirt,
/obj/machinery/light/small/directional/east,
/obj/effect/turf_decal/tile/yellow,
/obj/effect/turf_decal/tile/yellow{
	dir = 4
	},
/turf/open/floor/iron,
/area/template_noop)
"t" = (
/obj/structure/bed,
/obj/item/bedsheet/random,
/turf/open/floor/plating,
/area/template_noop)
"u" = (
/obj/item/chair,
/turf/open/floor/plating,
/area/template_noop)
"v" = (
/obj/structure/table,
/obj/item/reagent_containers/cup/bottle/sugar{
	pixel_x = 6
	},
/obj/item/reagent_containers/cup/bottle/sulfur{
	pixel_x = -6
	},
/obj/effect/decal/cleanable/dirt,
/obj/effect/turf_decal/tile/yellow{
	dir = 1
	},
/obj/effect/turf_decal/tile/yellow,
/obj/effect/turf_decal/tile/yellow{
	dir = 8
	},
/obj/structure/window/reinforced{
	dir = 8
	},
/turf/open/floor/iron,
/area/template_noop)
"w" = (
/obj/structure/table,
/obj/item/reagent_containers/cup/bottle/silver{
	pixel_x = 6
	},
/obj/item/reagent_containers/cup/bottle/sodium{
	pixel_x = -6
	},
/obj/effect/decal/cleanable/dirt,
/obj/effect/decal/cleanable/dirt,
/turf/open/floor/iron,
/area/template_noop)
"x" = (
/obj/structure/table,
/obj/item/reagent_containers/cup/bottle/sacid{
	pixel_x = 6
	},
/obj/item/reagent_containers/cup/bottle/silicon{
	pixel_x = -6
	},
/obj/effect/decal/cleanable/dirt,
/obj/effect/turf_decal/tile/yellow,
/obj/effect/turf_decal/tile/yellow{
	dir = 4
	},
/obj/effect/turf_decal/tile/yellow{
	dir = 8
	},
/turf/open/floor/iron,
/area/template_noop)
"y" = (
/obj/structure/table,
/obj/item/reagent_containers/cup/bottle/potassium{
	pixel_x = 6
	},
/obj/item/reagent_containers/cup/bottle/radium{
	pixel_x = -6
	},
/obj/item/reagent_containers/cup/bottle/welding_fuel{
	pixel_y = 8
	},
/obj/effect/decal/cleanable/dirt,
/obj/effect/turf_decal/tile/yellow,
/obj/effect/turf_decal/tile/yellow{
	dir = 4
	},
/turf/open/floor/iron,
/area/template_noop)

(1,1,1) = {"
a
c
e
c
t
"}
(2,1,1) = {"
b
j
e
j
e
"}
(3,1,1) = {"
c
c
e
c
c
"}
(4,1,1) = {"
d
e
e
q
u
"}
(5,1,1) = {"
e
e
e
e
e
"}
(6,1,1) = {"
e
k
k
b
m
"}
(7,1,1) = {"
f
l
o
r
v
"}
(8,1,1) = {"
g
m
p
m
w
"}
(9,1,1) = {"
h
e
e
m
x
"}
(10,1,1) = {"
i
n
m
s
y
"}
