//MAP CONVERTED BY dmm2tgm.py THIS HEADER COMMENT PREVENTS RECONVERSION, DO NOT REMOVE
"a" = (
/obj/structure/table,
/obj/effect/decal/cleanable/dirt/dust,
/obj/item/paper_bin{
	pixel_y = 3
	},
/obj/item/pen{
	pixel_y = 4
	},
/turf/open/floor/plating,
/area/template_noop)
"b" = (
/obj/effect/decal/cleanable/dirt/dust,
/turf/open/floor/plating,
/area/template_noop)
"c" = (
/obj/effect/decal/cleanable/dirt/dust,
/obj/structure/closet,
/turf/open/floor/plating,
/area/template_noop)
"d" = (
/obj/effect/turf_decal/delivery,
/obj/effect/decal/cleanable/dirt/dust,
/obj/structure/trash_pile,
/turf/open/floor/iron/dark,
/area/template_noop)
"e" = (
/obj/effect/turf_decal/stripes/corner,
/obj/effect/turf_decal/stripes/corner{
	dir = 8
	},
/obj/effect/decal/cleanable/dirt/dust,
/obj/effect/decal/cleanable/blood/old,
/turf/open/floor/iron/dark,
/area/template_noop)
"f" = (
/obj/effect/turf_decal/bot,
/obj/effect/decal/cleanable/dirt/dust,
/obj/machinery/light/built/directional/west,
/obj/structure/frame/machine,
/turf/open/floor/iron/dark,
/area/template_noop)
"g" = (
/obj/effect/turf_decal/stripes/line{
	dir = 8
	},
/obj/effect/turf_decal/stripes/line{
	dir = 4
	},
/obj/effect/decal/cleanable/dirt/dust,
/turf/open/floor/iron/dark,
/area/template_noop)
"i" = (
/obj/structure/table,
/obj/effect/decal/cleanable/dirt/dust,
/obj/machinery/light/broken/directional/east,
/turf/open/floor/plating,
/area/template_noop)
"k" = (
/obj/effect/turf_decal/stripes/line{
	dir = 8
	},
/obj/effect/turf_decal/stripes/corner{
	dir = 4
	},
/obj/effect/decal/cleanable/dirt/dust,
/turf/open/floor/iron/dark,
/area/template_noop)
"l" = (
/obj/effect/turf_decal/stripes/line{
	dir = 1
	},
/obj/effect/decal/cleanable/dirt/dust,
/turf/open/floor/iron/dark,
/area/template_noop)
"m" = (
/obj/effect/turf_decal/bot,
/obj/effect/decal/cleanable/dirt/dust,
/obj/structure/trash_pile,
/turf/open/floor/iron/dark,
/area/template_noop)

(1,1,1) = {"
a
b
f
m
"}
(2,1,1) = {"
b
b
g
k
"}
(3,1,1) = {"
b
d
m
l
"}
(4,1,1) = {"
b
e
b
b
"}
(5,1,1) = {"
c
b
i
m
"}
