//MAP CONVERTED BY dmm2tgm.py THIS HEADER COMMENT PREVENTS RECONVERSION, DO NOT REMOVE
"b" = (
/obj/structure/table,
/obj/effect/spawner/random/maintenance/three,
/turf/open/floor/wood,
/area/template_noop)
"c" = (
/obj/structure/table,
/obj/effect/spawner/random/maintenance/two,
/turf/open/floor/wood,
/area/template_noop)
"d" = (
/turf/open/floor/wood,
/area/template_noop)
"e" = (
/obj/effect/decal/cleanable/cobweb,
/obj/effect/spawner/random/structure/crate,
/obj/effect/mapping_helpers/broken_floor,
/turf/open/floor/wood,
/area/template_noop)
"f" = (
/obj/effect/mapping_helpers/broken_floor,
/turf/open/floor/plating,
/area/template_noop)
"s" = (
/obj/structure/sink/directional/east,
/turf/open/floor/iron,
/area/template_noop)
"K" = (
/obj/structure/bed/pod,
/obj/item/bedsheet/random,
/obj/effect/mapping_helpers/broken_floor,
/turf/open/floor/wood,
/area/template_noop)

(1,1,1) = {"
e
d
s
"}
(2,1,1) = {"
b
d
f
"}
(3,1,1) = {"
c
d
K
"}
