//MAP CONVERTED BY dmm2tgm.py THIS HEADER COMMENT PREVENTS RECONVERSION, DO NOT REMOVE
"a" = (
/turf/open/floor/iron/dark,
/area/template_noop)
"b" = (
/obj/item/kirbyplants{
	icon_state = "plant-21"
	},
/turf/open/floor/iron/dark,
/area/template_noop)
"c" = (
/obj/structure/table,
/obj/item/stack/sheet/iron/fifty,
/obj/item/stack/sheet/iron/fifty,
/obj/item/stack/sheet/glass/fifty,
/obj/machinery/light/small/directional/north,
/turf/open/floor/iron/dark,
/area/template_noop)
"d" = (
/obj/structure/table,
/obj/item/storage/box/lights/mixed,
/turf/open/floor/iron/dark,
/area/template_noop)
"e" = (
/obj/machinery/vending/cigarette,
/turf/open/floor/iron/dark,
/area/template_noop)
"f" = (
/obj/structure/closet/masks,
/obj/item/food/deadmouse,
/turf/open/floor/iron/dark,
/area/template_noop)
"g" = (
/obj/structure/closet/boxinggloves,
/turf/open/floor/iron/dark,
/area/template_noop)
"h" = (
/obj/machinery/door/window/right/directional/east{
	base_state = "left";
	dir = 8;
	icon_state = "left";
	name = "ARENA"
	},
/obj/structure/window/reinforced/spawner/directional/north,
/obj/structure/window/reinforced/spawner/directional/east,
/turf/open/floor/plating,
/area/template_noop)
"i" = (
/obj/effect/decal/cleanable/vomit/old,
/turf/open/floor/iron/dark,
/area/template_noop)
"j" = (
/obj/structure/window/reinforced/spawner/directional/south,
/obj/structure/window/reinforced/spawner/directional/west,
/obj/structure/window/reinforced/spawner/directional/east,
/mob/living/basic/chicken{
	name = "Roscoe Reichard"
	},
/turf/open/floor/plating,
/area/template_noop)
"k" = (
/obj/machinery/door/window/right/directional/east{
	base_state = "left";
	icon_state = "left";
	name = "ARENA"
	},
/obj/structure/window/reinforced/spawner/directional/south,
/obj/structure/window/reinforced/spawner/directional/west,
/turf/open/floor/plating,
/area/template_noop)
"l" = (
/obj/effect/spawner/random/maintenance,
/turf/open/floor/iron/dark,
/area/template_noop)
"m" = (
/obj/effect/turf_decal/tile/neutral{
	dir = 1
	},
/obj/effect/turf_decal/tile/neutral,
/obj/effect/turf_decal/tile/neutral{
	dir = 4
	},
/obj/effect/turf_decal/tile/neutral{
	dir = 8
	},
/turf/open/floor/iron/dark,
/area/template_noop)
"n" = (
/obj/structure/chair/comfy/black,
/obj/item/trash/pistachios,
/obj/effect/turf_decal/tile/neutral{
	dir = 1
	},
/obj/effect/turf_decal/tile/neutral,
/obj/effect/turf_decal/tile/neutral{
	dir = 4
	},
/obj/effect/turf_decal/tile/neutral{
	dir = 8
	},
/turf/open/floor/iron/dark,
/area/template_noop)
"o" = (
/obj/structure/chair/comfy/black,
/obj/item/stack/spacecash/c100,
/obj/effect/turf_decal/tile/neutral{
	dir = 1
	},
/obj/effect/turf_decal/tile/neutral,
/obj/effect/turf_decal/tile/neutral{
	dir = 4
	},
/obj/effect/turf_decal/tile/neutral{
	dir = 8
	},
/turf/open/floor/iron/dark,
/area/template_noop)
"p" = (
/obj/structure/chair/comfy/black,
/obj/effect/turf_decal/tile/neutral{
	dir = 1
	},
/obj/effect/turf_decal/tile/neutral,
/obj/effect/turf_decal/tile/neutral{
	dir = 4
	},
/obj/effect/turf_decal/tile/neutral{
	dir = 8
	},
/turf/open/floor/iron/dark,
/area/template_noop)
"q" = (
/obj/structure/chair/comfy/black,
/obj/item/cigbutt,
/obj/effect/turf_decal/tile/neutral{
	dir = 1
	},
/obj/effect/turf_decal/tile/neutral,
/obj/effect/turf_decal/tile/neutral{
	dir = 4
	},
/obj/effect/turf_decal/tile/neutral{
	dir = 8
	},
/turf/open/floor/iron/dark,
/area/template_noop)
"r" = (
/obj/item/trash/popcorn,
/obj/effect/turf_decal/tile/neutral{
	dir = 1
	},
/obj/effect/turf_decal/tile/neutral,
/obj/effect/turf_decal/tile/neutral{
	dir = 4
	},
/obj/effect/turf_decal/tile/neutral{
	dir = 8
	},
/turf/open/floor/iron/dark,
/area/template_noop)
"s" = (
/obj/effect/decal/cleanable/oil,
/turf/open/floor/iron/dark,
/area/template_noop)
"t" = (
/obj/structure/table,
/obj/effect/spawner/random/maintenance/two,
/turf/open/floor/iron/dark,
/area/template_noop)
"u" = (
/obj/machinery/door/window/right/directional/east{
	base_state = "left";
	dir = 8;
	icon_state = "left";
	name = "ARENA"
	},
/obj/structure/window/reinforced/spawner/directional/north,
/obj/structure/chair/stool,
/turf/open/floor/plating,
/area/template_noop)
"v" = (
/obj/structure/window/reinforced/spawner/directional/north,
/mob/living/basic/chicken{
	name = "Ali Rezun"
	},
/turf/open/floor/plating,
/area/template_noop)
"w" = (
/obj/structure/window/reinforced/spawner/directional/north,
/turf/open/floor/plating,
/area/template_noop)
"x" = (
/obj/structure/window/reinforced/spawner/directional/east,
/obj/structure/window/reinforced/spawner/directional/north,
/turf/open/floor/plating,
/area/template_noop)
"y" = (
/obj/item/stack/medical/gauze,
/obj/effect/turf_decal/tile/neutral{
	dir = 1
	},
/obj/effect/turf_decal/tile/neutral,
/obj/effect/turf_decal/tile/neutral{
	dir = 4
	},
/obj/effect/turf_decal/tile/neutral{
	dir = 8
	},
/turf/open/floor/iron/dark,
/area/template_noop)
"A" = (
/obj/effect/decal/cleanable/oil{
	icon_state = "floor6"
	},
/obj/effect/decal/cleanable/robot_debris/old,
/turf/open/floor/iron/dark,
/area/template_noop)
"B" = (
/obj/structure/window/reinforced/spawner/directional/west,
/turf/open/floor/plating,
/area/template_noop)
"C" = (
/turf/open/floor/plating,
/area/template_noop)
"D" = (
/obj/structure/window/reinforced/spawner/directional/east,
/turf/open/floor/plating,
/area/template_noop)
"E" = (
/obj/effect/decal/cleanable/blood/old,
/turf/open/floor/plating,
/area/template_noop)
"F" = (
/obj/item/stack/spacecash/c10,
/obj/effect/turf_decal/tile/neutral{
	dir = 1
	},
/obj/effect/turf_decal/tile/neutral,
/obj/effect/turf_decal/tile/neutral{
	dir = 4
	},
/obj/effect/turf_decal/tile/neutral{
	dir = 8
	},
/turf/open/floor/iron/dark,
/area/template_noop)
"H" = (
/obj/structure/window/reinforced/spawner/directional/east,
/obj/structure/window/reinforced/spawner/directional/north,
/obj/structure/window/reinforced/spawner/directional/west,
/mob/living/basic/chicken{
	name = "Adam Jensen"
	},
/turf/open/floor/plating,
/area/template_noop)
"I" = (
/obj/item/stack/medical/bruise_pack,
/turf/open/floor/iron/dark,
/area/template_noop)
"J" = (
/obj/structure/window/reinforced/spawner/directional/south,
/obj/structure/window/reinforced/spawner/directional/west,
/turf/open/floor/plating,
/area/template_noop)
"K" = (
/obj/structure/window/reinforced/spawner/directional/south,
/turf/open/floor/plating,
/area/template_noop)
"L" = (
/obj/structure/window/reinforced/spawner/directional/south,
/mob/living/basic/chicken{
	name = "Mikhail Tarkov"
	},
/turf/open/floor/plating,
/area/template_noop)
"M" = (
/obj/machinery/door/window/right/directional/east{
	base_state = "left";
	icon_state = "left";
	name = "ARENA"
	},
/obj/structure/window/reinforced/spawner/directional/south,
/obj/structure/chair/stool,
/turf/open/floor/plating,
/area/template_noop)
"N" = (
/obj/structure/chair/comfy/black{
	dir = 1
	},
/obj/effect/turf_decal/tile/neutral{
	dir = 1
	},
/obj/effect/turf_decal/tile/neutral,
/obj/effect/turf_decal/tile/neutral{
	dir = 4
	},
/obj/effect/turf_decal/tile/neutral{
	dir = 8
	},
/turf/open/floor/iron/dark,
/area/template_noop)
"O" = (
/obj/structure/reagent_dispensers/watertank,
/turf/open/floor/iron/dark,
/area/template_noop)
"Q" = (
/obj/structure/mop_bucket,
/obj/item/mop,
/turf/open/floor/iron/dark,
/area/template_noop)
"R" = (
/obj/structure/table,
/obj/item/stack/cable_coil,
/obj/item/extinguisher,
/turf/open/floor/iron/dark,
/area/template_noop)
"S" = (
/obj/structure/table,
/obj/effect/spawner/random/maintenance,
/turf/open/floor/iron/dark,
/area/template_noop)
"T" = (
/obj/structure/rack,
/obj/effect/spawner/random/maintenance,
/turf/open/floor/iron/dark,
/area/template_noop)
"U" = (
/obj/machinery/portable_atmospherics/canister/air,
/turf/open/floor/iron/dark,
/area/template_noop)
"V" = (
/obj/item/trash/chips,
/turf/open/floor/iron/dark,
/area/template_noop)
"W" = (
/obj/structure/table,
/obj/item/paper,
/obj/item/pen,
/turf/open/floor/iron/dark,
/area/template_noop)
"X" = (
/obj/structure/chair/stool,
/turf/open/floor/iron/dark,
/area/template_noop)

(1,1,1) = {"
a
t
t
t
a
a
H
k
a
R
"}
(2,1,1) = {"
b
a
l
a
A
a
I
a
a
S
"}
(3,1,1) = {"
c
a
m
m
m
m
m
m
a
T
"}
(4,1,1) = {"
d
a
n
u
B
B
J
N
a
U
"}
(5,1,1) = {"
a
a
o
v
C
C
K
N
a
a
"}
(6,1,1) = {"
a
a
p
w
C
E
L
N
a
a
"}
(7,1,1) = {"
e
i
q
x
D
D
M
N
a
V
"}
(8,1,1) = {"
f
a
r
y
m
F
m
m
a
W
"}
(9,1,1) = {"
a
a
a
a
a
a
a
a
a
X
"}
(10,1,1) = {"
g
a
h
j
a
s
a
a
Q
O
"}
