//MAP CONVERTED BY dmm2tgm.py THIS HEADER COMMENT PREVENTS RECONVERSION, DO NOT REMOVE
"a" = (
/obj/effect/turf_decal/tile/green,
/turf/open/floor/iron,
/area/template_noop)
"b" = (
/obj/effect/turf_decal/tile/green,
/obj/effect/turf_decal/tile/green{
	dir = 8
	},
/turf/open/floor/iron,
/area/template_noop)
"c" = (
/obj/effect/turf_decal/tile/green{
	dir = 8
	},
/turf/open/floor/iron,
/area/template_noop)
"d" = (
/obj/effect/turf_decal/tile/green{
	dir = 4
	},
/obj/effect/turf_decal/tile/green,
/turf/open/floor/iron,
/area/template_noop)
"e" = (
/obj/structure/closet/crate,
/obj/item/clothing/under/shorts/blue,
/obj/item/clothing/under/shorts/green,
/obj/item/clothing/under/shorts/red,
/obj/item/clothing/shoes/sandal,
/obj/item/clothing/shoes/sandal,
/obj/item/clothing/shoes/sandal,
/obj/item/clothing/glasses/sunglasses,
/obj/item/storage/toolbox/mechanical,
/turf/open/misc/beach/sand,
/area/template_noop)
"g" = (
/obj/structure/flora/bush/sparsegrass/style_random,
/turf/open/misc/beach/sand,
/area/template_noop)
"h" = (
/obj/effect/turf_decal/tile/green{
	dir = 1
	},
/obj/effect/turf_decal/tile/green{
	dir = 8
	},
/turf/open/floor/iron,
/area/template_noop)
"j" = (
/obj/structure/flora/coconuts,
/turf/open/misc/beach/sand,
/area/template_noop)
"k" = (
/obj/structure/flora/tree/palm/style_random,
/turf/open/misc/beach/sand,
/area/template_noop)
"l" = (
/turf/open/misc/beach/sand,
/area/template_noop)
"m" = (
/turf/open/misc/beach/coast,
/area/template_noop)
"n" = (
/turf/open/water/beach,
/area/template_noop)
"o" = (
/obj/effect/turf_decal/tile/green{
	dir = 4
	},
/turf/open/floor/iron,
/area/template_noop)
"p" = (
/obj/effect/turf_decal/tile/green{
	dir = 1
	},
/obj/effect/turf_decal/tile/green{
	dir = 4
	},
/turf/open/floor/iron,
/area/template_noop)
"q" = (
/obj/effect/turf_decal/tile/green{
	dir = 1
	},
/turf/open/floor/iron,
/area/template_noop)
"r" = (
/obj/effect/turf_decal/tile/green,
/obj/effect/turf_decal/tile/green{
	dir = 8
	},
/obj/machinery/light/directional/north,
/turf/open/floor/iron,
/area/template_noop)
"s" = (
/obj/effect/turf_decal/tile/green{
	dir = 4
	},
/obj/effect/turf_decal/tile/green,
/obj/machinery/light/directional/west,
/turf/open/floor/iron,
/area/template_noop)
"t" = (
/obj/effect/turf_decal/tile/green{
	dir = 1
	},
/obj/effect/turf_decal/tile/green{
	dir = 8
	},
/obj/machinery/light/directional/east,
/turf/open/floor/iron,
/area/template_noop)
"u" = (
/obj/item/toy/beach_ball,
/turf/open/misc/beach/sand,
/area/template_noop)
"v" = (
/obj/effect/turf_decal/tile/green{
	dir = 1
	},
/obj/effect/turf_decal/tile/green{
	dir = 4
	},
/obj/machinery/light/directional/south,
/turf/open/floor/iron,
/area/template_noop)
"w" = (
/mob/living/basic/crab,
/turf/open/misc/beach/sand,
/area/template_noop)
"x" = (
/obj/structure/fluff/beach_umbrella,
/turf/open/misc/beach/sand,
/area/template_noop)
"y" = (
/obj/effect/landmark/blobstart,
/turf/open/misc/beach/sand,
/area/template_noop)
"D" = (
/obj/structure/chair,
/turf/open/misc/beach/sand,
/area/template_noop)
"J" = (
/obj/structure/closet/crate/freezer{
	name = "Beer Cooler"
	},
/obj/item/reagent_containers/cup/glass/bottle/beer,
/obj/item/reagent_containers/cup/glass/bottle/beer,
/obj/item/reagent_containers/cup/glass/bottle/beer,
/obj/item/reagent_containers/cup/glass/bottle/beer,
/obj/item/reagent_containers/cup/glass/bottle/beer,
/obj/item/reagent_containers/cup/glass/bottle/beer,
/obj/item/reagent_containers/cup/glass/bottle/beer,
/obj/item/reagent_containers/cup/glass/bottle/beer,
/obj/item/reagent_containers/cup/glass/bottle/beer,
/obj/item/reagent_containers/cup/glass/bottle/beer,
/turf/open/misc/beach/sand,
/area/template_noop)

(1,1,1) = {"
a
d
d
s
d
d
s
d
d
o
"}
(2,1,1) = {"
b
e
l
l
l
l
l
m
n
p
"}
(3,1,1) = {"
b
l
g
l
l
l
l
m
n
p
"}
(4,1,1) = {"
r
l
l
y
j
l
l
m
n
v
"}
(5,1,1) = {"
b
l
l
l
k
x
l
m
n
p
"}
(6,1,1) = {"
b
l
l
w
u
D
l
m
n
p
"}
(7,1,1) = {"
r
g
l
l
l
J
l
m
n
v
"}
(8,1,1) = {"
b
l
l
k
l
g
l
m
n
p
"}
(9,1,1) = {"
b
l
l
l
l
l
l
m
n
p
"}
(10,1,1) = {"
c
h
h
t
h
h
t
h
h
q
"}
