//MAP CONVERTED BY dmm2tgm.py THIS HEADER COMMENT PREVENTS RECONVERSION, DO NOT REMOVE
"a" = (
/turf/template_noop,
/area/template_noop)
"b" = (
/turf/closed/wall/mineral/titanium,
/area/shuttle/arrival)
"c" = (
/obj/machinery/door/airlock/titanium{
	name = "Arrivals Shuttle Airlock"
	},
/obj/structure/fans/tiny,
/turf/open/floor/plating,
/area/shuttle/arrival)
"d" = (
/obj/effect/spawner/structure/window/reinforced/shuttle,
/turf/open/floor/plating,
/area/shuttle/arrival)
"e" = (
/obj/structure/table,
/obj/structure/window/spawner/directional/east,
/obj/item/storage/medkit/fire,
/obj/item/storage/medkit/regular{
	pixel_x = 3;
	pixel_y = 4
	},
/obj/item/crowbar,
/turf/open/floor/mineral/titanium/blue,
/area/shuttle/arrival)
"f" = (
/turf/open/floor/mineral/titanium/blue,
/area/shuttle/arrival)
"g" = (
/obj/effect/spawner/random/entertainment/arcade,
/obj/machinery/light/directional/north,
/turf/open/floor/mineral/titanium/blue,
/area/shuttle/arrival)
"h" = (
/obj/structure/closet/wardrobe/green,
/turf/open/floor/mineral/titanium/blue,
/area/shuttle/arrival)
"i" = (
/obj/structure/closet/wardrobe/black,
/turf/open/floor/mineral/titanium/blue,
/area/shuttle/arrival)
"j" = (
/obj/structure/closet/wardrobe/mixed,
/turf/open/floor/mineral/titanium/blue,
/area/shuttle/arrival)
"k" = (
/obj/structure/closet/wardrobe/grey,
/turf/open/floor/mineral/titanium/blue,
/area/shuttle/arrival)
"l" = (
/obj/machinery/requests_console/directional/north{
	department = "Arrival shuttle";
	name = "Arrival Shuttle Requests Console"
	},
/obj/structure/closet/firecloset,
/turf/open/floor/mineral/titanium/blue,
/area/shuttle/arrival)
"m" = (
/obj/machinery/power/shuttle_engine/heater{
	dir = 4
	},
/obj/structure/window/reinforced/spawner/directional/west,
/turf/open/floor/plating/airless,
/area/shuttle/arrival)
"n" = (
/obj/machinery/power/shuttle_engine/propulsion/burst/right{
	dir = 4
	},
/turf/open/floor/plating/airless,
/area/shuttle/arrival)
"p" = (
/obj/machinery/computer/crew{
	dir = 4
	},
/turf/open/floor/mineral/titanium/blue,
/area/shuttle/arrival)
"r" = (
/obj/structure/chair/comfy/shuttle{
	dir = 8
	},
/turf/open/floor/mineral/titanium,
/area/shuttle/arrival)
"s" = (
/obj/machinery/power/shuttle_engine/propulsion{
	dir = 4
	},
/turf/open/floor/plating/airless,
/area/shuttle/arrival)
"t" = (
/obj/machinery/door/airlock/titanium{
	name = "Arrivals Shuttle Airlock"
	},
/turf/open/floor/mineral/titanium,
/area/shuttle/arrival)
"u" = (
/obj/machinery/power/shuttle_engine/propulsion{
	dir = 4
	},
/obj/docking_port/mobile/arrivals,
/turf/open/floor/plating/airless,
/area/shuttle/arrival)
"v" = (
/obj/machinery/modular_computer/preset/civilian{
	dir = 4
	},
/turf/open/floor/mineral/titanium/blue,
/area/shuttle/arrival)
"w" = (
/obj/structure/chair/comfy/shuttle{
	dir = 8
	},
/obj/machinery/light/small/directional/east,
/turf/open/floor/mineral/titanium/blue,
/area/shuttle/arrival)
"x" = (
/obj/structure/closet/emcloset,
/turf/open/floor/mineral/titanium/blue,
/area/shuttle/arrival)
"y" = (
/obj/machinery/light/directional/south,
/obj/machinery/vending/wallmed/directional/south,
/turf/open/floor/mineral/titanium/blue,
/area/shuttle/arrival)
"A" = (
/obj/machinery/power/shuttle_engine/propulsion/burst/left{
	dir = 4
	},
/turf/open/floor/plating/airless,
/area/shuttle/arrival)
"L" = (
/turf/template_noop,
/area/shuttle/arrival)
"S" = (
/turf/open/floor/mineral/titanium,
/area/shuttle/arrival)
"T" = (
/obj/machinery/computer{
	dir = 4;
	name = "Shuttle computer"
	},
/turf/open/floor/mineral/titanium/blue,
/area/shuttle/arrival)
"U" = (
/obj/item/radio/intercom/directional/south,
/turf/open/floor/mineral/titanium/blue,
/area/shuttle/arrival)

(1,1,1) = {"
a
b
d
d
d
b
a
"}
(2,1,1) = {"
a
b
p
T
v
b
a
"}
(3,1,1) = {"
a
d
w
S
w
d
a
"}
(4,1,1) = {"
b
b
b
t
b
b
b
"}
(5,1,1) = {"
b
e
S
S
S
x
b
"}
(6,1,1) = {"
c
f
r
r
r
f
c
"}
(7,1,1) = {"
b
g
f
f
f
U
b
"}
(8,1,1) = {"
d
h
r
r
r
f
d
"}
(9,1,1) = {"
d
i
f
f
f
f
d
"}
(10,1,1) = {"
d
j
r
r
r
f
d
"}
(11,1,1) = {"
d
k
f
f
f
f
d
"}
(12,1,1) = {"
b
l
r
r
r
y
b
"}
(13,1,1) = {"
c
f
S
S
S
f
c
"}
(14,1,1) = {"
b
m
m
m
m
m
b
"}
(15,1,1) = {"
L
n
s
u
s
A
L
"}
