//MAP CONVERTED BY dmm2tgm.py THIS HEADER COMMENT PREVENTS RECONVERSION, DO NOT REMOVE
"a" = (
/obj/machinery/chem_heater,
/obj/effect/decal/cleanable/dirt,
/turf/open/floor/plating,
/area/template_noop)
"b" = (
/obj/effect/decal/cleanable/dirt,
/turf/open/floor/plating,
/area/template_noop)
"c" = (
/obj/structure/rack,
/obj/effect/spawner/random/clothing/costume,
/turf/open/floor/plating,
/area/template_noop)
"d" = (
/obj/machinery/light/small/built/directional/west,
/mob/living/basic/crab,
/turf/open/floor/plating,
/area/template_noop)
"e" = (
/obj/effect/decal/cleanable/dirt,
/mob/living/basic/crab,
/turf/open/floor/plating,
/area/template_noop)
"f" = (
/obj/effect/spawner/random/decoration/glowstick,
/turf/open/floor/plating,
/area/template_noop)
"g" = (
/mob/living/basic/crab/evil,
/turf/open/floor/plating,
/area/template_noop)
"h" = (
/obj/effect/spawner/random/maintenance,
/obj/effect/decal/cleanable/dirt,
/turf/open/floor/plating,
/area/template_noop)
"i" = (
/mob/living/basic/crab,
/turf/open/floor/plating,
/area/template_noop)
"j" = (
/obj/machinery/light/small/directional/east,
/obj/effect/decal/cleanable/dirt,
/mob/living/basic/crab,
/turf/open/floor/plating,
/area/template_noop)
"k" = (
/obj/effect/decal/cleanable/dirt,
/obj/effect/spawner/random/engineering/tank,
/turf/open/floor/plating,
/area/template_noop)
"l" = (
/obj/item/mop,
/obj/effect/decal/cleanable/dirt,
/obj/effect/spawner/random/trash/mopbucket,
/turf/open/floor/plating,
/area/template_noop)

(1,1,1) = {"
a
d
f
i
k
"}
(2,1,1) = {"
b
b
g
b
h
"}
(3,1,1) = {"
c
e
h
j
l
"}
